R 1440 900
NO ./texts/smooth.xpm
EA ./texts/bricks.xpm
SO ./texts/rock.xpm
WE ./texts/relief.xpm

S texts/pharaoh.xpm
F 133,255,45
C 255,45,233

1111 111111
1221   1221
1011 211101
1111  11101
1111  11101
11111111101
10000000001
100000N0001
11111111111
