R 1920 1080
NO
EA
SO
WE

S
F 233, 255, 254
C 255, 0, 0

11111111111
11011001101
10000000001
10011001101
10011111111
10011111111
10011111111
10011111111
10111111111
1N011111111
11111111111
