R 1920 1080
NO
EA
SO
WE

S
F 233, 255, 254
C 255, 0, 0

1111111111111111
1101100110000001
1S00000000111111
10011001101
10011111111
10011
10011
10011
10111
11011
1111
