R 1920 1080
NO ./texts/smooth.xpm
EA ./texts/bricks.xpm
SO ./texts/rock.xpm
WE ./texts/relief.xpm

S
F 138, 108, 13
C 138, 108, 13

1111111111111111
1101111110000001
1E00000000111111
10011001101
10011111111
10011
10011
10011
10111
11011
1111
