R 1920 1080
NO
EA
SO
WE

S
F 233, 255, 254
C 255, 0, 0

11111111111
10011001101
10000000001
10011001101
10011111111
10011
10011
10011
10011
1N011
1111
