R 1080 690
NO ./texts/smooth.xpm
EA
SO
WE

S
F 233, 0, 254
C 255, 0, 0

1111111111111111
1101111110000001
1E00000000111111
10011001101
10011111111
10011
10011
10011
10111
11011
1111
