R 1090 1080
NO
EA
SO
WE
S
F 233, 255, 254
C 255, 0, 0


11111111111
10001001101
1E000000001
10001001101
11111111111
