R 17000 17000
NO ./texts/smooth.xpm
EA ./texts/bricks.xpm
SO ./texts/rock.xpm
WE ./texts/relief.xpm

S ./texts/pharaoh.xpm
F 133,255,2
C 255,45,233

111111111111
102010011010
100S00000010
10001201101
11111111111



