R 1090 690
NO ./texts/smooth.xpm
EA
SO
WE

S
F 133, 255, 45
C 255, 45, 233


11111111111
10001001101
10N00000001
10001001101
11111111111
