R 1080 690
NO ./texts/smooth.xpm
EA ./texts/bricks.xpm
SO ./texts/rock.xpm
WE ./texts/relief.xpm

S ./texts/pharaoh.xpm
F 133,255,45
C 255,45,233


11111111111
10001001101
100000000W1
10001001101
11111111111
