R 1300       900
NO ./texts/smooth.xpm
EA ./texts/bricks.xpm
SO ./texts/rock.xpm
WE ./texts/relief.xpm

S ./texts/pharaoh.xpm
F 0   ,   0   , 0
C 255   ,   255   ,   255

111111111111
102010011010
100S00000010
10001201101
11111111111