R 1920 1080
NO
EA
SO
WE
S
F 233, 255, 254
C 255, 0, 0

11111111111
10011001101
1E000000001
10011001101
11111111111
