R 1440 900
NO ./texts/smooth.xpm
EA ./texts/bricks.xpm
SO ./texts/rock.xpm
WE ./texts/relief.xpm

S texts/pharaoh.xpm
F 133,255,45
C 255,45,233

       1111
       1001
11111111001
10001221101
1E00000000111111
1000122110100001
1000111110100201

10111   10000001
101     101000010000
101     10111111
101     101
101     101
101     101
111     101
        111