R 1440 900
NO ./texts/smooth.xpm
EA ./texts/bricks.xpm
SO ./texts/rock.xpm
WE ./texts/relief.xpm

S ./texts/pharaoh.xpm
F 133, 255, 45
C 255, 45, 233


11111111111
10001221101
100020000W1
10001221101
10001111101
10111   101
101     101
101     101
101     101
101     101
101     101
111     101
111     111
