R 1090 690
NO ./texts/smooth.xpm
EA ./texts/bricks.xpm
SO ./texts/rock.xpm
WE ./texts/relief.xpm

S ./texts/pharaoh.xpm
F 133, 255, 45
C 255, 45, 233


11111111111
12001201101
120000000W1
12001201101
11111111111
